type octile
height 120
width 120
map
.............................................@...................................................@...............@......
.@.........@...............@........................................@......................@...................@........
.....................................................@..............................@...........@..........@............
............@....................................@.@...........@...........@.........@.....@............................
...................@.........................................................@..............................@......@....
.....@.........................@.............@........................@................................@.....@..........
......................................................@..@......@........................@......@...@.................@.
.........@......................@.......@..................@...........................@................................
...@.@........................................................................................@.....@............@......
........................................@..............@..................@..........@..................................
................................................@......................@................................................
...................@...............................................@...........................@...@.................@.@
......@....@......................................@.............................................@....@@............@....
@.........@..@.....................................................@@........@...@....@.................................
.............................@...........@.................@............@.................@.................@..........@
.............................................................@.....@......@...@.........................@...............
....@..............................@.............@..........@..........@.........@......................................
..................@.@..................................................@@...............................................
........@...................................................................................@...........@...@...........
............@..........................@..............@....................@...............@......................@.....
.......@............@.......................@.....@...........@.............@..............@............................
.......@.............@.@@......@.........................................@..............................................
.......@..............................@........@........................................................................
...................@.....................................................@..............@........@......................
..........@...@...@........@...................................................................................@........
.......@@............................@..@............@....................................@.............................
...................................@@.@.........@.........................................@....@........................
..........@......@.....................................................................@................................
.........@...@........................................................................@................@................
..........................@......@................@....@..@@..............@@..@........@......@.........................
.............@.................@@......@..................................@...........@....@...................@........
.................................@......................................@........@......................................
.....@...........@.....................@.............@@....................................@............................
.....@.......................................@................................@.@...@..................@................
....@..........................................................................................@@...........@...........
.............@..@@...@..........................@....@....................@.............................................
.......@.................@.................................@..........@......................................@.....@....
...........@......................................................@...........@....................@.....@..............
......@@@................@..................................................................@.....@.......@....@........
...@.......@.........@...@....@..............@...@..........@............................................@..........@...
.@.........@...............................................@........................@.....@...@.........................
...............@..........@................................................@....@.......................................
..................................@.........@........@............@..........@@.........................................
............................................................@...........@...............................................
........................@..........................................................@......................@.............
.@...............................................@........................................................@.............
...................................@..............................@...@..................................@..............
.............................................@..............................@............@..............................
.............................................@@..................@...........................@...........@..............
......@.........@..@...@...@.............@@..............@...................@.......@........@...................@.....
.......................................@...@..........@..........................................@......................
....................@.................@..........@.......................................................@..............
..@......................@......@.....................................@....................@............................
.......................@............@......@..................@.....................................@...................
.............@....@@................@...@........@............................................@....@.........@.....@....
.@..............................@....................@.......................@....@.....................................
....................@......@...@@@@...............@@..............@.....................................................
............................................@.....@@...............@.....@...@...........@...........@..................
....@.........@................................@.@..........................@...@..@......@..........@..@...............
.....................@...........@.................@...........@.........................@.................@..@.@.......
...........................@.@@...@..................@....................................@.......................@.....
..@..........@@....................@................@........................@............@.........@.....@.............
..@.........................................@.....................@......................@..............................
@.....................@...................................@..............@..................@..@...................@....
.@@.................@..................................................@................................................
.......@...............@..............@...@...@........@.......................@@.......................................
........................@....................................@..............................................@...........
...........................................@......................@..............@.....@@...............................
...............................@..........................@......@..........@..@..................@@....................
.........@........@.@.......@.......@..............@........@.......@...............................@...................
@.............@......@...@....@...............................@..............@........@.........@......@.@@.............
.....................@..............@...............@....................@.......................@@.....................
...........@........@........@@..............................@........@...............................@.................
@........................@......................@..@......................@.............................................
........................................@....@..............................@..........@......@.........................
..................@..........@..............@.....@.....@.....@.......@...@....@..................@.@.........@.........
@.......................@@.......................................................@......................................
..............@.......................................@.............@...................................................
.................@...........................................@..............@..................@......@......@..........
............@..@.........................................................@........................@..@..................
.........@..........................................................@..@..........@.....................................
.@.............@......@@..............................@..@.........................................@.@..........@.....@.
..............................................................@.@................@...........................@..........
........@.....@.....................@.............@...................@.................................................
...........@..........@@.........@....@..............@.........@.........@................................@.@..@........
................@..........@.................@..@...@.......................@.............................@.............
......................................@@....@....@.......@.........................................@....................
..@...........................................................................@............................@...........@
.....@...........@.........@..@.............................................................@..@.....@........@.........
...........@...........@.....@....................@............@@...................................@...................
......@.....................@............@..@.............@.............................................................
.......................................@.............................@@........@........@........@............@........@
......@.@.....@.........................@.........@......................................@.......................@......
.............@....................@......@................@..........@.......@.......................................@..
...............@...............@....................................................................@...........@.@.....
...@..@.............................@...............@...........................................@..@.........@........@.
........@...........@.......................@.......@......................@..@...........@.......@.....................
........@..@..................@...............................................................@..............@..........
..........................................................@..................@..........................@...............
..........................................@............................@......@@....@...........@.......................
............................................................@........@..............@.............@@......@.............
..............@.........................@............@...............@...@@........@...@................................
.....................@..........@................@................@.....@....................@..........................
.............@........................................@...................................................@@............
.................................................@.@..@...........@...@...@...................................@.........
...........................@.................@..@..@...........................................@.@.@..........@.........
...................@.............................................................@..........@...........................
...........@...........@...@......@....@....@...........@.............................................@..@..............
....@.......................................@.......@..@.................@............................................@.
.......@......@....................................................@....................................................
.......@.....................@...........................@......@............................@..........................
.............................@........................................................................@....@............
............................@................@..................@..@........@.............................@.........@...
........................................@...@.......@..........@....@........@@...................@..@...............@..
.@.@................@.........................................@@...................................@............@.......
.............@.....................@.....................@.....................................@........................
...............................................................................@...............................@....@...
..............@........................@.................@.@.............@......@.......................................
...@....................@....@...@.@@......@...@.@.@........@..........................@...............................@
@..................@......................................@................................@......@..........@..........
