type octile
height 32
width 64
map
.........................@............@......@..................
.........@.......@...........................................@..
...@.....................@..........@@...................@...@..
.............@........................@............@............
.....@....@.....................................................
......@@...............................@....@.............@.....
................................................................
...@.......................................@...................@
............................................@...................
....................................@....@......................
...@................@..............@............................
......@.....................@....................@.............@
@..........................@...........@.....@..................
@..............................@.........................@......
............@...................................@...............
.............@..................................................
...@.....@@.@...............@...........@............@@.........
.......@..................@.......................@.......@.....
....................@.......@...................@...............
.......@.................@....@..........@@................@....
..........@@....................................................
...........................................@.@...@..............
@......@........@@........................@......@..............
................................................................
...................@............................@...@...........
..........................................@.....@...........@...
................@....@.@........................................
.....................@............@............@................
.............................@.............@....................
.........@.......................@@..@............@...........@.
..@...............................@...............@.............
...............................@.............@..................
